WWWWWWWWWW
W  S    YW
W VHH  A W
W   b    W
WB  WWXXbW
W  TCX T  
W    WY  W
W  W WR  W
W        W
WWWWWWWW W