WWWWWWWWWW
W  BS    W
Wb HHH  bW
W   b  bbW
W   bWXTWW
Wbbbbb    
WbYbWbbHVW
WbACbWbbbW
WbbbbbbbbW
WWWWWWWWWW