 B A     W
b   A    W
W   XX   W
WASbb M  W
W XXXXX  W
W      FF 
W         
WYRRR  R R
WXXXWWWWWX
WWTWWWWWWW