 BT      W
 R  b RR W
WC WWWW  W
W SR     W
W      XXW
W F RR   X
W W WWW   
W    R    
WX   R  FW
WWTWWWWWWW