WWWWWW WWW
W AC     W
W CCT R  W
W CC  C  W
W  C  WXXW
W      X  
WS     X X
W  B  R   
Wbbb  bbbW
WWWWWWWWWW