WWWWWWWWWW
W       YW
W VHH  A W
W   b    W
WB  WWXX W
Wb TCX T  
W  S WY  W
W  W WR  W
WbbbbbbbbW
WWWWWWWWWW