WWWWWWWWWW
W   A b  W
W   X W  W
W    C   W
WB   S X W
W b  X T  
W H      W
W  W WR  W
Wbbb  bbbW
WWWWWWWWWW