WWWWWWWWWW
W  B     W
Wb   S   W
W   T    W
W  WWWXXTW
W     T   
W Y W    W
W ACbW    
W     W WW
WWWWWWWWWW