WWWWWWWWWW
W        W
W  HHV  AW
W  Abb   W
WB  CWXT W
WS TCW    
W    WY  W
W  X WR  W
W        W
WWWWWWWWWW