WWWWWWWWWW
W  B     W
W  HHHH bW
W   b  bbW
W   bWXTWW
W         
W  SWWW  W
W   bW   W
W        W
WWWWWWWWWW